10 8
..........
.B........
.biy......
.rip......
.fiw......
.wiy......
.pip......
..........